1,1,1,1,1,1,0,1,1,1,1,1,1,5,5,5
1,1,1,1,1,1,0,1,1,1,1,1,1,5,5,5
1,1,1,1,1,0,0,0,1,1,1,1,1,5,5,5
1,1,1,1,1,0,0,0,1,1,1,1,1,5,5,5
1,1,1,1,1,4,0,1,1,1,1,1,1,5,5,5
1,1,1,1,1,1,1,1,1,1,1,1,1,5,5,5
1,1,1,1,1,2,0,0,1,1,1,1,1,5,5,5
1,1,1,1,1,0,3,0,1,1,1,1,1,5,5,5
1,1,1,1,1,1,0,1,1,1,1,1,1,5,5,5
